##############################################################################################################################################################
#                                        ########                    ############                                      ########                              #
#                                        ########                    ############                                      ########                              #
#                                        ########                    ############                                      ########                              #
#                                        ########                    ############                                      ########                              #
#                                        ########                    ############                                      ########                              #
#                                        ########                    ############                                      ########                              #
#                                        ########        ########################################                      ########          ########            #
#                                        ########        ########################################                      ########          ########            #
#                                        ########        ########################################                      ########          ########            #
#          ########                      ########        ########################################                      ########          ########            #
#          ########                      ########        ########################################                      ########          ########            #
#          ########                      ########        ########################################                      ########          ########            #
#          ########                      ########        ########################################                      ########          ########            #
#          ########                      ########        ########################################                      ########          ########            #
#          ########                      ########                                                                                        ########            #
#          ########                      ########                                                                                        ########            #
#          ########                      ########                                                                                        ########            #
#          ########                      ########                                                                                        ########            #
#          ########                      ########                                                                                        ########            #
#          ########                      ########                                                                                        ########            #
#          ########                                        ################################################            ########          ########            #
#          ########                                        ################################################            ########          ########            #
#          ########                                        ################################################            ########          ########            #
#          ########                                        ################################################            ########          ########            #
#          ########                                        ################################################            ########          ########            #
###################################                        ################################################            ########          ########            #
###################################                        ################################################            ########          ########            #
###################################                        ##########                                                  ########          ########            #
###################################                        ##########                                                  ########          ########            #
###################################                        ##########                                                  ########          ########            #
###################################                        ##########                                                  ########          ########            #
###################################                        ##########                                                  ########          ########            #
###################################                        ##########                                                  ########          ########            #
#                                                          ##########                                                  ########          ########            #
#                                                          ##########                                                                                        #
#                                                          ##########                                                                                        #
#                                                          ##########                                                                                        #
#                                                          ##########                                                                                        #
#                                                          ##########                                                                                        #
##############################################################################################################################################################
