##############################################################################################################################################################
#                      ######                  ################                  ######        ############################        ######                    #
#                      ######                  ################                  ######        ############################        ######                    #
#                      ######                  ################                  ######        ############################        ######                    #
#                      ######                  ################                  ######        ############################        ######                    #
###########            ######                  ################                  ######                          ######            ######                    #
###########            ######                  ################                  ######                          ######            ######                    #
###########            ######                  ################                  ######                          ######            ##############            #
###########            ######      ######      ################                  ######                          ######            ##############            #
###########            ######      ######                ######      ######      ######                          ######            ##############            #
###########            ######      ######                ######      ######      ######                  ##############            ##############            #
#                      ######      ######                ######      ######      ######                  ##############            ##############            #
#                      ######      ######                ######      ######      ######                  ##############            ##############            #
#                      ######      ######                ######      ######      ######                  ##############            ##############            #
#                      ######      ######                ######      ######      ######                  ##############            ######                    #
#                      ######      ######                ######                  ######                  ##############            ######                    #
#                      ######      ######                ######                  ######                          ######                                      #
#                      ######      ######                ######                  ######                          ######                                      #
#                      ######      ######                ######                  ######                          ######                                      #
#################                  ######                                        ######                          ######                                #######
#################                  ######                                        ######                          ######                                #######
#################                  ######                                        ######                          ######                                #######
#################                  ######                                        ######      ######              ######                                #######
#################                  ######                                        ######      ######              ######                                #######
#################                  ######     ##########################         ######      ######              #########################             #######
#        ########                  ######     ##########################                     ######              #########################                   #
#        ########                             ##########################                     ######              #########################                   #
#        ################                     ##########################                     ######              #########################                   #
#        ################                     ##########################                     ######              #########################                   #
#        ################                     ##########################                     ######              #########################                   #
#        ################                     ######                                         ######                                              ######      #
#        ################                     ######                                         ######                                              ######      #
#        ################                     ######                                         ######                                              ######      #
#                                             ######                                         ######                                              ######      #
#                             ######          ###############################                ######                                              ######      #
#                             ######          ###############################                ######                                              ######      #
#                             ######          ###############################                ######                            ######            ######      #
#                             ######          ###############################                ######                            ######            ######      #
#                             ######          ###############################                ######                            ######            ######      #
#                             ######          ###############################                ######                            ######            ######      #
##############################################################################################################################################################
