##############################################################################################################################################################
#####      #######                    ######                              ######            ######                ######                                     #
#####      #######                    ######                              ######            ######                ######                                     #
#####      #######                    ######                              ######            ######                ######                                     #
#####      #######                    ######                          ##########            ######                ######                                     #
#####      #######                    ######                          ##########            ######                ######      ######      ############       #
#####      #######                    ######                          ##########            ######                ######      ######      ############       #
#                                     ######        ############      ##########    ##############                ######      ######      ############       #
#                      ##########     ######        ############                    ##############                ######      ######      ############       #
#                      ##########     ######        ############                    ##############                ######      ######      ############       #
#                      ##########     ######        ############                    ##############                ######      ######      ############       #
#                      ##########     ######        ############                    ##############                ######      ########################       #
#                                     ######        ############                    ##############                ######      ########################       #
#####      ######                     ####################                                  ######                ######      ########################       #
#####      ######                     ####################                                  ######                ######      ########################       #
#####      ######                     ####################                                  ################      ######      ########################       #
#####      ######                     ####################                                  ################      ######      ########################       #
#####      ######                     ####################                                  ################      ######      ######      ############       #
############################          ####################                                  ################      ######      ######      ############       #
############################          ######        ########################                ################      ######      ######      ############       #
############################          ######        ########################                ################      ######      ######      ############       #
############################          ######        ########################                ######                ######      ######                         #
#####                 ######          ######        ########################                ######                ######      ######                         #
#####                 ######          ######        ########################                ######                ######      ######                         #
#####                 ######          ######        ########################                ######                ######      ######                         #
#####                 ######          ######                                                            ######    ######      ################################
#####                                 ######                                                            ######    ######      ################################
#####      ######                     ######                                                            ######    ######      ################################
#####      ######                     ######                                                            ######    ######      ################################
#####      ######                     ################################                                  ######    ######      ################################
#####      ######                     ################################                                  ######    ######      ################################
#####                                 ################################                                                                                       #
#####                ###########      ################################                                                                                       #
#####                ###########      ################################                                                                                       #
#####                ###########      ################################             ######                             ########                               #
#####                ###########                                                   ######                             ########                               #
#####                ####                                                          ######                             ########                               #
#####                ####                                                          ######                             ########                               #
#####                ####                                                          ######                             ########                               #
#####                ####                                                          ######                             ########                               #
##############################################################################################################################################################
