##############################################################################################################################################################
############     ##################################           ###########     #########      #################################################################
############     ##################################           ###########     #########      ######      ######     #####     ####    ###   ##################
############     ##################################           ###########     #########      ######      ######     #####     ####    ###   ##################
############     ########            ##########               ###########         #####      ######      ######     #####     ####    ###   ##################
############     ########            ##########               ###########         #####                  ######     #####     ####                           #
############     ########   ####     ##########    ####       ###########         #####                  ######     #####     ####                           #
#                ########   ####     ##########    ####       ###########         #####                  ######     #####     ####          #####            #
#                                    ##########               ###########     #########                  ######               ####          #####            #
#                                                       #################     #########     #######      ######               ####     #######################
#                                                       #################     #########     #######      ######               ####     #######################
#################            #######                    #################         #####     #######      ######                             #####            #
#################            #######                    #################         #####     #######                                         #####            #
#################            #######     ####           #################         #####     #######                                                          #
#################            #######     ####           #################     #########     #######                                                          #
#                            #######     ####                 ###########     #########                                                                      #
#                            ################                 ###########     #########                           ########     #############     ##########  #
#                            ################                 ###########                              #######    ########     #############     ##########  #
############                 ################                 ###########                              #######         ###     ###      ####     ###    ###  #
############                 ####################             ###########                   #####      #######         ###########      ############    ######
#################################################             ###########                   #####      #######         ###########      ############    ######
#################################################             ###########                   #####                                                            #
#    ############################################             ####################     ##########                                                            #
#    ############################################             ####################     ##########                                                            #
#                                                             ####################     ##########                                                            #
#                                                   ####      ####################     #####       ####    ####    ####    ####    ####    ####    ####    ###
#                                                   ####      ####################     #####       ####    ####    ####    ####    ####    ####    ####    ###
######     ####        ########      ####           ####      ####################     #####       ####    ####    ####    ####    ####    ####    ####    ###
######     ####        ########      ####                                                                                                                    #
######     ####        ########      ####                                                                                                                    #
######     ####        ########      ####                                                                                                                    #
###############        ##################                   #############################                         #####    ############     ############     #
###############        ##################                   #############################                         #####    ############     ############     #
#########################################                   #############################                         #####    ###     ####     ####     ###     #
#########################################                   #############################              ######     ############     #############     #########
#########################################                                                              ######     ############     #############     #########
#########################################       #######                                       ###############                                                #
#########################################       #######                                       ###############                                                #
#########################################       #######                                       ###############                                                #
#########################################       #######                                       ###############                                                #
##############################################################################################################################################################
