##############################################################################################################################################################
#                    ####    ######             ######      ######                  ####    ######################       ######      #########################
#                    ####    ######             ######      ######                  ####    ######################       ######      #########################
#                    ####    ######             ######      ######                  ####    ######################       ######      #########################
#                    ####    ######             ######      ######                  ####    ######################       ######      #########################
#   #######    ##########    ######             ######      ######     ####         ####                    ######       ######                              #
#   #######    ##########    ######             ######      ######     ####         ####                    ######       ######                              #
#   #######    ##########    ###############                ######     ####         ####                    ######                                           #
#   #######    ##########    ###############                ######     ####         ####                    ######                                           #
#   #######    ##########    ###############                ######     #################################    ######                                           #
#   #####################    ###############                ######     #################################    ######                                           #
#   #####################    ###############    ######      ######     #################################    ######        ######                             #
#   #####################    ###############    ######      ######     #################################    ######        ######                             #
#   #######          ####                       ######      ######     #################################    ######        ######                             #
#   #######          ####                       ######      ######     #################################    ######        ####################      ##########
#   #######    ##########                       ######                 ####              ####     ######       ######     ####################      ##########
#   #######    ##########              ###############                 ####              ####     ######       ######     ####################      ##########
#   #######    ##########              ###############                 ####              ####     ######       ######     ####################      ##########
#   #######    ##########              ###############      ######     ####    #####     ####     ######       ######     ####################      ##########
#   #######                  ######    ###############      ######     ####    #####     ####     ######       ######     ######                             #
#   #######                  ######           ########      ######     ####    #####     ####     ######       ######     ######                             #
#   #######                  ######           ########      ######     ####    #####     ####     ########       ####     ######                             #
#   #######                  #####################################     ####    #####     ####     ########       ###################    ######################
#   #############            #####################################     ####    #####     ####     ########       ###################    ######################
#          ######    ####    #####################################     ####    #####     ####     ########       ###################    ######################
#          ######    ####    #####################################     ####    #####     ####                    ####     ######                             #
#          ######    ####    ######                   ######           ####    #####     ####                 ######      ######                             #
#          ######    ####    ######                   ######           ####    #####     ####                 ######      ######                             #
#    ############            ######                   ######           ####              ####     ######      ######      ######                             #
#    ############            ######      ######       ######           ####              ####     ######      ######      ######                             #
#    ############            ######      ######       ######           ####              ####     ######      ######      #########################       ####
#    ############            ######      ######       ######       ########              ####     ######      ######      #########################       ####
#          ######    ####    ######      ######                    ########              ####     ######      ######      #########################       ####
#          ######    ####    ######      ######                    ########    ##############     ######      ######      #########################       ####
#          ######    ####    ######      ######                    ########    ##############     ######      ######                                         #
#          ######    ####    ######      ######                    ########    ##############     ######      ######                                         #
#######                      ######      ######       ######       ########    ##############     ######      ######            ##########                   #
#######                      ######      ######       ######                                      ######                        ##########                   #
#######                      ######      ######       ######                                      ######                        ##########                   #
#######                      ######      ######       ######                                      ######                        ##########                   #
##############################################################################################################################################################